Caracteres comodines :

* > Reemplaza dos o mas caracteres.
? > Reemplaza a un caracter.

---
cd > Change Directory : Cambiar de directorios.
ll > List : Listar el contenido de la carpeta.
pwd > ... : Conocer la ruta absoluta donde estoy parad@.
clear / cls > Clear : Limpiar la pantalla.

---
mkdir [ nombre del archivo ] > Make Directory : Crear carpetas.
mkdir -p [ nombre de archivo ] > Make Directory : Crear carpetas con un sistema de archivos interno.

---
OJO! CUIDADO! PELIGROSO!

rm [ nombre del archivo ] > Remove : Eliminar archivos.
rm -rfd [ Destino ] > Remove -Recursivo + -Force + -Directorys : Eliminar carpetas y contenido.


---
cp [ archivo a copiar ] [ nuevo nombre ] > Copy : Copiar archivos.
mv [ archivo a mover ] [ destino / ] > Move : Mover un archivo a una carpeta.
mv [ archivo a renombrar ] [ nuevo nombre ] > Renombrar archivos.

**** BUG ****

cat [Nombre del Archivo] > Ver el contenido sin entrarr
head [Nombre del Archivo] > Ver las primeras letras
less [Nombre del Archivo] > Ver el contenido

echo 'Contenido a imprimir' > Imprimir un texto en pantalla
tldr + comando (npm install -g tldr)

---
git init > Iniciar el programa de Git y transformar una carpeta en un repositorio.
git add [ nombre del archivo ] > Agregar archivos a Git de: fuera del flujo de trabajo a la **Staging Area**.
git add . > Agregan archivos a **todo** Git de: fuera del flujo de trabajo a la **Staging Area**.

git status > Conocer el estado de los arhivos dentro del repositorio.


Comandos de la terminal : ac (Alias para Add-Content): Agrega contenido a un archivo.
asnp (Alias para Add-PSSnapin): Agrega un complemento de PSSnapin al contexto de la sesión.
cat (Alias para Get-Content): Obtiene el contenido de un archivo.
cd (Alias para Set-Location): Cambia el directorio de trabajo actual.
CFS (Alias para ConvertFrom-String): Convierte el contenido de un archivo de texto en objetos PowerShell.
chdir (Alias para Set-Location): Cambia el directorio de trabajo actual.
clc (Alias para Clear-Content): Borra el contenido de un archivo.
clear (Alias para Clear-Host): Limpia la pantalla de la consola.
clhy (Alias para Clear-History): Borra el historial de comandos.
cli (Alias para Clear-Item): Borra un elemento (archivo o directorio).
clp (Alias para Clear-ItemProperty): Borra propiedades de un objeto.
cls (Alias para Clear-Host): Limpia la pantalla de la consola.
clv (Alias para Clear-Variable): Borra variables.
cnsn (Alias para Connect-PSSession): Conecta una sesión de PowerShell remota.
compare (Alias para Compare-Object): Compara dos conjuntos de objetos.
copy (Alias para Copy-Item): Copia archivos o directorios.
cp (Alias para Copy-Item): Copia archivos o directorios.
cpi (Alias para Copy-Item): Copia archivos o directorios.
cpp (Alias para Copy-ItemProperty): Copia propiedades de un objeto a otro.
curl (Alias para Invoke-WebRequest): Realiza una solicitud web.
cvpa (Alias para Convert-Path): Convierte una ruta de acceso en una ruta de acceso completa.
dbp (Alias para Disable-PSBreakpoint): Deshabilita puntos de interrupción en PowerShell.
del (Alias para Remove-Item): Elimina archivos o directorios.
diff (Alias para Compare-Object): Compara dos conjuntos de objetos.
dir (Alias para Get-ChildItem): Obtiene los elementos en un directorio.
dnsn (Alias para Disconnect-PSSession): Desconecta una sesión de PowerShell remota.
ebp (Alias para Enable-PSBreakpoint): Habilita puntos de interrupción en PowerShell.
echo (Alias para Write-Output): Muestra un mensaje en la consola.
epal (Alias para Export-Alias): Exporta alias a un archivo de script.
epcsv (Alias para Export-Csv): Exporta datos al formato CSV.
epsn (Alias para Export-PSSession): Exporta una sesión de PowerShell remota.
erase (Alias para Remove-Item): Elimina archivos o directorios.
etsn (Alias para Enter-PSSession): Ingresa a una sesión de PowerShell remota.
exsn (Alias para Exit-PSSession): Sale de una sesión de PowerShell remota.
fc (Alias para Format-Custom): Formatea objetos como lista personalizada.
fhx (Alias para Format-Hex): Formatea datos como hexadecimal.
fl (Alias para Format-List): Formatea objetos como una lista.
foreach (Alias para ForEach-Object): Ejecuta un bloque de comandos para cada elemento en una colección.
ft (Alias para Format-Table): Formatea objetos como una tabla.
fw (Alias para Format-Wide): Formatea objetos en una vista de ancho fijo.
gal (Alias para Get-Alias): Obtiene información sobre los alias.
gbp (Alias para Get-PSBreakpoint): Obtiene puntos de interrupción en PowerShell.
gc (Alias para Get-Content): Obtiene el contenido de un archivo.
gcb (Alias para Get-Clipboard): Obtiene el contenido del portapapeles.
gcm (Alias para Get-Command): Obtiene información sobre los comandos disponibles.
gcs (Alias para Get-PSCallStack): Obtiene la pila de llamadas actual.
gdr (Alias para Get-PSDrive): Obtiene información sobre las unidades disponibles.
ghy (Alias para Get-History): Obtiene el historial de comandos ejecutados.
gi (Alias para Get-Item): Obtiene información sobre un elemento (archivo o directorio).
gin (Alias para Get-ComputerInfo): Obtiene información sobre el sistema.
gjb (Alias para Get-Job): Obtiene información sobre trabajos en segundo plano.
gl (Alias para Get-Location): Obtiene la ubicación actual.
gm (Alias para Get-Member): Obtiene información sobre las propiedades y métodos de un objeto.
gmo (Alias para Get-Module): Obtiene información sobre los módulos cargados.
gp (Alias para Get-ItemProperty): Obtiene propiedades de un objeto.
gps (Alias para Get-Process): Obtiene información sobre los procesos en ejecución.
gpv (Alias para Get-ItemPropertyValue): Obtiene el valor de una propiedad específica de un objeto.
group (Alias para Group-Object): Agrupa objetos según una propiedad común.
gsn (Alias para Get-PSSession): Obtiene información sobre sesiones de PowerShell.
gsnp (Alias para Get-PSSnapin): Obtiene información sobre PSSnapins cargados.
gsv (Alias para Get-Service): Obtiene información sobre servicios del sistema.
gtz (Alias para Get-TimeZone): Obtiene información sobre la zona horaria actual.
gu (Alias para Get-Unique): Obtiene valores únicos de una colección.
gv (Alias para Get-Variable): Obtiene información sobre las variables disponibles.
gwmi (Alias para Get-WmiObject): Obtiene instancias de clases WMI (Windows Management Instrumentation).
h (Alias para Get-History): Obtiene el historial de comandos ejecutados.
history (Alias para Get-History): Otro alias para obtener el historial de comandos ejecutados.
icm (Alias para Invoke-Command): Ejecuta comandos en un equipo remoto.
iex (Alias para Invoke-Expression): Ejecuta una cadena como una expresión.
ihy (Alias para Invoke-History): Ejecuta comandos desde el historial.
ii (Alias para Invoke-Item): Ejecuta un programa o archivo.
ipal (Alias para Import-Alias): Importa alias desde un archivo.
ipcsv (Alias para Import-Csv): Importa datos desde un archivo CSV.
ipmo (Alias para Import-Module): Importa un módulo al shell de PowerShell.
ipsn (Alias para Import-PSSession): Importa sesiones de PowerShell desde otra sesión o equipo.
irm (Alias para Invoke-RestMethod): Envía una solicitud RESTful a un servicio web.
ise (Alias para powershell_ise.exe): Inicia el entorno de scripting integrado de PowerShell.
iwmi (Alias para Invoke-WmiMethod): Invoca un método WMI en un objeto.
iwr (Alias para Invoke-WebRequest): Invoca una solicitud web HTTP/HTTPS.
kill (Alias para Stop-Process): Detiene un proceso en ejecución.
lp (Alias para Out-Printer): Envia datos de salida a la impresora.
ls (Alias para Get-ChildItem): Obtiene la lista de elementos en una ubicación.
man (Alias para help): Muestra la ayuda para un cmdlet o función.
md (Alias para mkdir): Crea un nuevo directorio.
measure (Alias para Measure-Object): Mide las propiedades de un objeto.
mi (Alias para Move-Item): Mueve un elemento desde una ubicación a otra.
mount (Alias para New-PSDrive): Monta una unidad en el sistema.
move (Alias para Move-Item): Otro alias para mover un elemento.
mp (Alias para Move-ItemProperty): Mueve una propiedad de un objeto a otro.
mv (Alias para Move-Item): Otro alias para mover un elemento.
nal (Alias para New-Alias): Crea un nuevo alias.
ndr (Alias para New-PSDrive): Crea una nueva unidad en el sistema.
ni (Alias para New-Item): Crea un nuevo elemento (archivo o directorio).
nmo (Alias para New-Module): Crea un nuevo módulo.
npssc (Alias para New-PSSessionConfigurationFile): Crea un nuevo archivo de configuración de sesión de PowerShell.
nsn (Alias para New-PSSession): Crea una nueva sesión de PowerShell.
nv (Alias para New-Variable): Crea una nueva variable.
ogv (Alias para Out-GridView): Muestra datos en una ventana de cuadrícula interactiva.
oh (Alias para Out-Host): Envia la salida a la ventana de host.
popd -> Pop-Location: Remueve la ubicación actual de la pila de ubicaciones y establece la ubicación actual en la última ubicación almacenada en la pila.
ps -> Get-Process: Obtiene información sobre los procesos en el sistema.
pushd -> Push-Location: Almacena la ubicación actual en la pila de ubicaciones y establece la ubicación actual en la especificada.
pwd -> Get-Location: Obtiene la ruta del directorio actual.
r -> Invoke-History: Ejecuta comandos del historial de comandos.
rbp -> Remove-PSBreakpoint: Remueve un punto de interrupción en PowerShell.
rcjb -> Receive-Job: Obtiene los resultados de un trabajo en segundo plano.
rcsn -> Receive-PSSession: Recibe una sesión de PowerShell remota.
rd -> Remove-Item: Remueve un ítem (archivo o directorio).
rdr -> Remove-PSDrive: Remueve una unidad de PowerShell.
ren -> Rename-Item: Cambia el nombre de un ítem.
ri -> Remove-Item: Remueve un ítem (archivo o directorio).
rjb -> Remove-Job: Remueve un trabajo en segundo plano.
rm -> Remove-Item: Remueve un ítem (archivo o directorio).
rmdir -> Remove-Item: Remueve un ítem (archivo o directorio).
rmo -> Remove-Module: Remueve un módulo de PowerShell.
rni -> Rename-Item: Cambia el nombre de un ítem.
rnp -> Rename-ItemProperty: Cambia el nombre de una propiedad de ítem.
rp -> Remove-ItemProperty: Remueve una propiedad de un ítem.
rsn -> Remove-PSSession: Remueve una sesión de PowerShell remota.
rsnp -> Remove-PSSnapin: Remueve un complemento de PowerShell.
rujb -> Resume-Job: Reanuda un trabajo en segundo plano.
rv -> Remove-Variable: Remueve una variable.
rvpa -> Resolve-Path: Resuelve la ruta de un ítem.
rwmi -> Remove-WmiObject: Remueve un objeto de administración de Windows (WMI).
sajb -> Start-Job: Inicia un trabajo en segundo plano.
sal -> Set-Alias: Crea o cambia un alias (nombre alternativo) para un comando.
saps -> Start-Process: Inicia un nuevo proceso.
stz -> Set-TimeZone: Establece la zona horaria del sistema.
sv -> Set-Variable: Establece el valor de una variable.
swmi -> Set-WmiInstance: Establece el valor de una instancia de administración de Windows (WMI).
tee -> Tee-Object: Envía la entrada a un archivo y también a la salida estándar.
trcm -> Trace-Command: Habilita/deshabilita el seguimiento (trace) de comandos.
type -> Get-Content: Obtiene el contenido de un archivo.
wget -> Invoke-WebRequest: Descarga contenido de la web.
where -> Where-Object: Filtra objetos de una colección según un criterio.
wjb -> Wait-Job: Espera a que un trabajo en segundo plano se complete.
write -> Write-Output: Escribe datos en la salida estándar.



-------------
Texto que se agrega a un commit:

Estructura : 
'[Texto]( [Archivos] ): [Descripción del commit, hasta 50 caracteres].'

Ejemplo: 
'Docs(Readme.md): Creación de documentación' 


Feat :
Fix :
Docs :
Style :
Refactor :
Test :
Perf :



